,country,year,gender,gold,silver,bronze,total
0,United States,1896,male,11,7,2,20
1,Greece,1896,male,10,16,18,44
2,France,1896,male,5,4,2,11
3,Germany,1896,male,4,5,2,11
4,Great Britain,1896,male,2,3,2,7
5,Hungary,1896,male,2,1,3,6
6,Austria,1896,male,2,1,2,5
7,Australia,1896,male,2,0,0,2
8,Denmark,1896,male,1,2,3,6
9,Switzerland,1896,male,1,2,0,3
10,France,1900,male,21,22,22,65
11,United States,1900,male,18,13,12,43
12,Great Britain,1900,male,8,6,7,21
13,Belgium,1900,male,6,4,5,15
14,Italy,1900,male,3,2,0,5
15,Switzerland,1900,male,3,1,1,5
16,Denmark,1900,male,1,3,2,6
17,Hungary,1900,male,1,2,2,5
18,Cuba,1900,male,1,1,0,2
19,Germany,1900,male,1,1,0,2
20,Austria,1900,male,0,3,3,6
21,India,1900,male,0,2,0,2
22,Norway,1900,male,0,1,3,4
23,Bohemia,1900,male,0,1,0,1
24,Australia,1900,male,0,0,3,3
25,Netherlands,1900,male,0,0,1,1
26,Sweden,1900,male,0,0,1,1
27,United States,1904,male,65,69,69,203
28,Germany,1904,male,5,4,5,14
29,Cuba,1904,male,3,0,0,3
30,Hungary,1904,male,2,1,1,4
31,Canada,1904,male,2,0,0,2
32,Great Britain,1904,male,1,1,0,2
33,Greece,1904,male,1,0,1,2
34,Great Britain,1908,male,30,31,25,86
35,United States,1908,male,20,11,11,42
36,Sweden,1908,male,6,3,8,17
37,France,1908,male,2,5,5,12
38,Hungary,1908,male,2,3,1,6
39,Canada,1908,male,2,2,5,9
40,Germany,1908,male,2,2,4,8
41,Italy,1908,male,2,1,0,3
42,Norway,1908,male,1,2,3,6
43,Russian Federation,1908,male,1,2,0,3
44,Finland,1908,male,1,1,2,4
45,Belgium,1908,male,1,1,1,3
46,South Africa,1908,male,1,1,0,2
47,Greece,1908,male,0,3,1,4
48,Australasia,1908,male,0,2,2,4
49,Denmark,1908,male,0,1,3,4
50,Austria,1908,male,0,0,1,1
51,Bohemia,1908,male,0,0,1,1
52,United States,1912,male,21,17,15,53
53,Sweden,1912,male,11,14,14,39
54,Finland,1912,male,9,5,6,20
55,Germany,1912,male,4,10,4,18
56,France,1912,male,4,3,1,8
57,Italy,1912,male,4,1,2,7
58,Canada,1912,male,3,2,3,8
59,South Africa,1912,male,3,2,0,5
60,Great Britain,1912,male,2,6,5,13
61,Hungary,1912,male,2,1,3,6
62,Belgium,1912,male,1,1,2,4
63,Greece,1912,male,1,0,1,2
64,Denmark,1912,male,0,2,2,4
65,Australasia,1912,male,0,1,3,4
66,Russian Federation,1912,male,0,1,2,3
67,Norway,1912,male,0,1,1,2
68,Austria,1912,male,0,0,1,1
69,United States,1920,male,23,21,20,64
70,Sweden,1920,male,13,14,15,42
71,Finland,1920,male,13,9,7,29
72,Belgium,1920,male,9,5,8,22
73,Italy,1920,male,8,4,4,16
74,France,1920,male,6,9,6,21
75,Great Britain,1920,male,5,7,10,22
76,Norway,1920,male,4,3,5,12
77,South Africa,1920,male,3,1,2,6
78,Canada,1920,male,2,3,3,8
79,Switzerland,1920,male,1,2,3,6
80,Estonia,1920,male,1,2,0,3
81,Brazil,1920,male,1,1,0,2
82,Netherlands,1920,male,1,0,2,3
83,Denmark,1920,male,0,7,1,8
84,Australia,1920,male,0,1,1,2
85,Japan,1920,male,0,1,0,1
86,Luxembourg,1920,male,0,1,0,1
87,New Zealand,1920,male,0,0,1,1
88,United States,1924,male,27,19,18,64
89,Finland,1924,male,12,13,9,34
90,France,1924,male,9,7,9,25
91,Great Britain,1924,male,6,6,7,19
92,Switzerland,1924,male,5,6,7,18
93,Italy,1924,male,5,2,2,9
94,Sweden,1924,male,3,10,6,19
95,Belgium,1924,male,3,3,2,8
96,Australia,1924,male,3,0,2,5
97,Hungary,1924,male,2,2,3,7
98,Norway,1924,male,2,1,3,6
99,Netherlands,1924,male,2,1,1,4
100,Yugoslavia,1924,male,2,0,0,2
101,Czechoslovakia,1924,male,1,4,5,10
102,Denmark,1924,male,1,4,2,7
103,Estonia,1924,male,1,1,4,6
104,South Africa,1924,male,1,1,1,3
105,Luxembourg,1924,male,1,1,0,2
106,Greece,1924,male,1,0,0,1
107,Argentina,1924,male,0,3,2,5
108,Austria,1924,male,0,3,1,4
109,Ireland,1924,male,0,1,1,2
110,Canada,1924,male,0,0,1,1
111,Japan,1924,male,0,0,1,1
112,Monaco,1924,male,0,0,1,1
113,New Zealand,1924,male,0,0,1,1
114,Poland,1924,male,0,0,1,1
115,United States,1928,male,11,12,12,35
116,Finland,1928,male,8,8,9,25
117,Sweden,1928,male,7,5,6,18
118,France,1928,male,6,9,5,20
119,Germany,1928,male,5,7,13,25
120,Switzerland,1928,male,5,5,4,14
121,Netherlands,1928,male,4,4,3,11
122,Hungary,1928,male,4,4,0,8
123,Italy,1928,male,3,4,5,12
124,Great Britain,1928,male,3,3,2,8
125,Argentina,1928,male,3,2,0,5
126,Austria,1928,male,3,0,0,3
127,Czechoslovakia,1928,male,2,4,2,8
128,Canada,1928,male,2,2,3,7
129,Denmark,1928,male,2,1,4,7
130,Egypt,1928,male,2,1,1,4
131,Estonia,1928,male,2,1,1,4
132,Japan,1928,male,2,0,1,3
133,Australia,1928,male,1,2,1,4
134,Yugoslavia,1928,male,1,1,2,4
135,Poland,1928,male,1,0,1,2
136,South Africa,1928,male,1,0,1,2
137,Ireland,1928,male,1,0,0,1
138,Luxembourg,1928,male,1,0,0,1
139,New Zealand,1928,male,1,0,0,1
140,Belgium,1928,male,0,1,1,2
141,Norway,1928,male,0,1,1,2
142,Chile,1928,male,0,1,0,1
143,Haiti,1928,male,0,1,0,1
144,Philippines,1928,male,0,0,1,1
145,United States,1932,male,25,26,21,72
146,Italy,1932,male,9,7,10,26
147,Sweden,1932,male,9,4,7,20
148,Japan,1932,male,6,5,4,15
149,France,1932,male,6,4,3,13
150,Finland,1932,male,5,8,11,24
151,Hungary,1932,male,4,5,3,12
152,Germany,1932,male,3,7,6,16
153,Great Britain,1932,male,3,3,1,7
154,Argentina,1932,male,3,1,0,4
155,Canada,1932,male,2,2,4,8
156,Netherlands,1932,male,2,2,1,5
157,Australia,1932,male,2,0,1,3
158,South Africa,1932,male,2,0,1,3
159,Ireland,1932,male,2,0,0,2
160,Poland,1932,male,2,0,0,2
161,Czechoslovakia,1932,male,1,3,2,6
162,Denmark,1932,male,0,4,1,5
163,Mexico,1932,male,0,2,0,2
164,Austria,1932,male,0,1,3,4
165,Latvia,1932,male,0,1,0,1
166,Switzerland,1932,male,0,1,0,1
167,Philippines,1932,male,0,0,3,3
168,Belgium,1932,male,0,0,1,1
169,Spain,1932,male,0,0,1,1
170,Uruguay,1932,male,0,0,1,1
171,Germany,1936,male,22,21,21,64
172,United States,1936,male,17,17,8,42
173,Finland,1936,male,8,6,5,19
174,Hungary,1936,male,6,1,3,10
175,France,1936,male,5,4,2,11
176,Sweden,1936,male,5,3,7,15
177,Italy,1936,male,4,8,5,17
178,Japan,1936,male,4,4,10,18
179,Austria,1936,male,4,3,2,9
180,Switzerland,1936,male,3,6,3,12
181,Estonia,1936,male,2,2,3,7
182,Netherlands,1936,male,2,1,3,6
183,Egypt,1936,male,2,1,2,5
184,Czechoslovakia,1936,male,1,4,1,6
185,Great Britain,1936,male,1,3,1,5
186,Argentina,1936,male,1,1,2,4
187,Canada,1936,male,1,1,2,4
188,Norway,1936,male,1,1,1,3
189,Türkiye,1936,male,1,0,1,2
190,New Zealand,1936,male,1,0,0,1
191,Poland,1936,male,0,1,3,4
192,Latvia,1936,male,0,1,1,2
193,Romania,1936,male,0,1,0,1
194,South Africa,1936,male,0,1,0,1
195,Yugoslavia,1936,male,0,1,0,1
196,Denmark,1936,male,0,0,2,2
197,Australia,1936,male,0,0,1,1
198,Belgium,1936,male,0,0,1,1
199,Mexico,1936,male,0,0,1,1
200,Philippines,1936,male,0,0,1,1
201,United States,1948,male,23,21,13,57
202,Sweden,1948,male,14,9,14,37
203,Finland,1948,male,8,7,4,19
204,Hungary,1948,male,7,2,9,18
205,Italy,1948,male,6,5,8,19
206,Türkiye,1948,male,6,4,2,12
207,Switzerland,1948,male,5,8,6,19
208,France,1948,male,5,4,8,17
209,Czechoslovakia,1948,male,4,1,3,8
210,Argentina,1948,male,3,1,1,5
211,Australia,1948,male,2,4,2,8
212,South Africa,1948,male,2,2,2,6
213,Egypt,1948,male,2,2,1,5
214,Great Britain,1948,male,1,7,3,11
215,Denmark,1948,male,1,2,4,7
216,Belgium,1948,male,1,2,2,5
217,Austria,1948,male,1,2,1,4
218,Jamaica,1948,male,1,2,0,3
219,Mexico,1948,male,1,1,1,3
220,Poland,1948,male,1,0,1,2
221,Peru,1948,male,1,0,0,1
222,Norway,1948,male,0,2,2,4
223,Canada,1948,male,0,2,1,3
224,Netherlands,1948,male,0,1,4,5
225,Sri Lanka,1948,male,0,1,0,1
226,Trinidad and Tobago,1948,male,0,1,0,1
227,Uruguay,1948,male,0,1,0,1
228,Yugoslavia,1948,male,0,1,0,1
229,Panama,1948,male,0,0,2,2
230,Republic of Korea,1948,male,0,0,2,2
231,Islamic Republic of Iran,1948,male,0,0,1,1
232,Puerto Rico,1948,male,0,0,1,1
233,United States,1952,male,30,16,10,56
234,Soviet Union,1952,male,15,16,12,43
235,Sweden,1952,male,9,8,8,25
236,Hungary,1952,male,6,6,7,19
237,Czechoslovakia,1952,male,5,2,2,9
238,Italy,1952,male,4,6,2,12
239,France,1952,male,3,4,3,10
240,Finland,1952,male,3,3,9,15
241,Switzerland,1952,male,2,3,4,9
242,Australia,1952,male,2,2,1,5
243,Türkiye,1952,male,2,0,1,3
244,Norway,1952,male,2,0,0,2
245,Japan,1952,male,1,5,2,8
246,Jamaica,1952,male,1,3,0,4
247,Poland,1952,male,1,2,1,4
248,Romania,1952,male,1,1,2,4
249,Belgium,1952,male,1,1,0,2
250,Canada,1952,male,1,1,0,2
251,Brazil,1952,male,1,0,2,3
252,Denmark,1952,male,1,0,1,2
253,Luxembourg,1952,male,1,0,0,1
254,Germany,1952,male,0,3,11,14
255,Islamic Republic of Iran,1952,male,0,3,4,7
256,Argentina,1952,male,0,2,2,4
257,South Africa,1952,male,0,1,4,5
258,Great Britain,1952,male,0,1,3,4
259,Lebanon,1952,male,0,1,1,2
260,Chile,1952,male,0,1,0,1
261,Ireland,1952,male,0,1,0,1
262,Mexico,1952,male,0,1,0,1
263,Spain,1952,male,0,1,0,1
264,Republic of Korea,1952,male,0,0,2,2
265,Trinidad and Tobago,1952,male,0,0,2,2
266,Bulgaria,1952,male,0,0,1,1
267,Egypt,1952,male,0,0,1,1
268,India,1952,male,0,0,1,1
269,New Zealand,1952,male,0,0,1,1
270,Venezuela,1952,male,0,0,1,1
271,Soviet Union,1956,male,25,18,22,65
272,United States,1956,male,21,15,13,49
273,Japan,1956,male,4,9,5,18
274,Italy,1956,male,4,5,7,16
275,Australia,1956,male,4,4,6,14
276,Romania,1956,male,4,2,3,9
277,Sweden,1956,male,3,3,5,11
278,Great Britain,1956,male,3,3,4,10
279,Türkiye,1956,male,3,2,2,7
280,Finland,1956,male,3,1,8,12
281,France,1956,male,3,1,3,7
282,Hungary,1956,male,2,6,3,11
283,Germany,1956,male,2,4,1,7
284,Islamic Republic of Iran,1956,male,2,2,1,5
285,Bulgaria,1956,male,1,3,0,4
286,Ireland,1956,male,1,1,3,5
287,Norway,1956,male,1,0,2,3
288,Canada,1956,male,1,0,1,2
289,Mexico,1956,male,1,0,1,2
290,Brazil,1956,male,1,0,0,1
291,Denmark,1956,male,1,0,0,1
292,New Zealand,1956,male,1,0,0,1
293,Poland,1956,male,0,3,3,6
294,Czechoslovakia,1956,male,0,2,1,3
295,Belgium,1956,male,0,2,0,2
296,Chile,1956,male,0,1,2,3
297,Argentina,1956,male,0,1,1,2
298,Republic of Korea,1956,male,0,1,1,2
299,Iceland,1956,male,0,1,0,1
300,Yugoslavia,1956,male,0,1,0,1
301,South Africa,1956,male,0,0,3,3
302,Greece,1956,male,0,0,1,1
303,Soviet Union,1960,male,25,15,19,59
304,United States,1960,male,20,17,12,49
305,Italy,1960,male,8,7,6,21
306,Türkiye,1960,male,7,2,0,9
307,Australia,1960,male,6,4,4,14
308,Hungary,1960,male,4,5,3,12
309,Poland,1960,male,4,3,8,15
310,Germany,1960,male,3,9,3,15
311,Japan,1960,male,3,6,5,14
312,Romania,1960,male,2,1,3,6
313,New Zealand,1960,male,2,0,1,3
314,Denmark,1960,male,2,0,0,2
315,Bulgaria,1960,male,1,3,3,7
316,Great Britain,1960,male,1,1,8,10
317,Finland,1960,male,1,1,2,4
318,Czechoslovakia,1960,male,1,0,2,3
319,Austria,1960,male,1,0,0,1
320,Ethiopia,1960,male,1,0,0,1
321,Belgium,1960,male,0,2,2,4
322,Switzerland,1960,male,0,2,1,3
323,Islamic Republic of Iran,1960,male,0,1,3,4
324,Sweden,1960,male,0,1,3,4
325,France,1960,male,0,1,2,3
326,South Africa,1960,male,0,1,2,3
327,United Arab Republic,1960,male,0,1,1,2
328,Chinese Taipei,1960,male,0,1,0,1
329,Ghana,1960,male,0,1,0,1
330,Morocco,1960,male,0,1,0,1
331,Singapore,1960,male,0,1,0,1
332,Yugoslavia,1960,male,0,1,0,1
333,Argentina,1960,male,0,0,1,1
334,Brazil,1960,male,0,0,1,1
335,Iraq,1960,male,0,0,1,1
336,Mexico,1960,male,0,0,1,1
337,Netherlands,1960,male,0,0,1,1
338,Pakistan,1960,male,0,0,1,1
339,Venezuela,1960,male,0,0,1,1
340,West Indies Federation,1960,male,0,0,1,1
341,United States,1964,male,19,14,17,50
342,Soviet Union,1964,male,15,22,22,59
343,Japan,1964,male,14,5,5,24
344,Italy,1964,male,8,5,5,18
345,Poland,1964,male,6,1,7,14
346,Hungary,1964,male,5,5,3,13
347,Germany,1964,male,3,11,11,25
348,Bulgaria,1964,male,3,5,2,10
349,Australia,1964,male,3,0,4,7
350,Finland,1964,male,3,0,2,5
351,Great Britain,1964,male,2,7,1,10
352,Czechoslovakia,1964,male,2,3,1,6
353,Türkiye,1964,male,2,3,1,6
354,Yugoslavia,1964,male,2,0,2,4
355,Belgium,1964,male,2,0,1,3
356,New Zealand,1964,male,2,0,1,3
357,France,1964,male,1,3,3,7
358,Sweden,1964,male,1,1,2,4
359,Switzerland,1964,male,1,1,1,3
360,Ethiopia,1964,male,1,0,0,1
361,Netherlands,1964,male,1,0,0,1
362,Romania,1964,male,0,3,3,6
363,Canada,1964,male,0,2,1,3
364,Republic of Korea,1964,male,0,2,1,3
365,Denmark,1964,male,0,1,2,3
366,Trinidad and Tobago,1964,male,0,1,1,2
367,Tunisia,1964,male,0,1,1,2
368,Argentina,1964,male,0,1,0,1
369,Cuba,1964,male,0,1,0,1
370,Philippines,1964,male,0,1,0,1
371,Islamic Republic of Iran,1964,male,0,0,2,2
372,Ghana,1964,male,0,0,1,1
373,Ireland,1964,male,0,0,1,1
374,Kenya,1964,male,0,0,1,1
375,Mexico,1964,male,0,0,1,1
376,Nigeria,1964,male,0,0,1,1
377,Uruguay,1964,male,0,0,1,1
378,United States,1968,male,22,18,23,63
379,Soviet Union,1968,male,18,20,13,51
380,Japan,1968,male,10,5,6,21
381,Hungary,1968,male,6,5,6,17
382,East Germany,1968,male,6,2,3,11
383,Poland,1968,male,4,2,7,13
384,France,1968,male,4,2,3,9
385,Kenya,1968,male,3,3,2,8
386,Great Britain,1968,male,3,2,2,7
387,Mexico,1968,male,3,2,2,7
388,Australia,1968,male,3,1,1,5
389,Italy,1968,male,2,3,5,10
390,Bulgaria,1968,male,2,3,3,8
391,Islamic Republic of Iran,1968,male,2,1,2,5
392,Türkiye,1968,male,2,0,0,2
393,West Germany,1968,male,1,7,7,15
394,Romania,1968,male,1,3,3,7
395,Finland,1968,male,1,2,1,4
396,Yugoslavia,1968,male,1,1,2,4
397,Ethiopia,1968,male,1,1,0,2
398,Czechoslovakia,1968,male,1,0,3,4
399,Sweden,1968,male,1,0,1,2
400,Tunisia,1968,male,1,0,1,2
401,Netherlands,1968,male,1,0,0,1
402,Venezuela,1968,male,1,0,0,1
403,Denmark,1968,male,0,3,1,4
404,Cuba,1968,male,0,2,0,2
405,Mongolia,1968,male,0,1,3,4
406,Brazil,1968,male,0,1,1,2
407,Republic of Korea,1968,male,0,1,1,2
408,Uganda,1968,male,0,1,1,2
409,Austria,1968,male,0,1,0,1
410,Belgium,1968,male,0,1,0,1
411,Cameroon,1968,male,0,1,0,1
412,Canada,1968,male,0,1,0,1
413,Jamaica,1968,male,0,1,0,1
414,Argentina,1968,male,0,0,2,2
415,New Zealand,1968,male,0,0,2,2
416,Switzerland,1968,male,0,0,2,2
417,Greece,1968,male,0,0,1,1
418,Soviet Union,1972,male,28,16,12,56
419,United States,1972,male,18,21,21,60
420,Japan,1972,male,10,7,8,25
421,East Germany,1972,male,7,4,11,22
422,Bulgaria,1972,male,6,8,2,16
423,Hungary,1972,male,5,6,12,23
424,Poland,1972,male,5,3,6,14
425,West Germany,1972,male,4,5,7,16
426,Sweden,1972,male,3,3,5,11
427,Italy,1972,male,3,2,6,11
428,Romania,1972,male,3,2,3,8
429,Finland,1972,male,3,1,3,7
430,Cuba,1972,male,3,1,1,5
431,Netherlands,1972,male,3,0,0,3
432,France,1972,male,2,3,4,9
433,Czechoslovakia,1972,male,2,1,0,3
434,Norway,1972,male,2,0,0,2
435,Australia,1972,male,1,4,0,5
436,Kenya,1972,male,1,3,4,8
437,Great Britain,1972,male,1,2,8,11
438,Democratic People's Republic of Korea,1972,male,1,1,2,4
439,Yugoslavia,1972,male,1,1,2,4
440,Uganda,1972,male,1,1,0,2
441,Denmark,1972,male,1,0,0,1
442,Islamic Republic of Iran,1972,male,0,2,1,3
443,Belgium,1972,male,0,2,0,2
444,Greece,1972,male,0,2,0,2
445,Colombia,1972,male,0,1,2,3
446,Austria,1972,male,0,1,1,2
447,Argentina,1972,male,0,1,0,1
448,Canada,1972,male,0,1,0,1
449,Lebanon,1972,male,0,1,0,1
450,Mexico,1972,male,0,1,0,1
451,Mongolia,1972,male,0,1,0,1
452,Republic of Korea,1972,male,0,1,0,1
453,Switzerland,1972,male,0,1,0,1
454,Tunisia,1972,male,0,1,0,1
455,Türkiye,1972,male,0,1,0,1
456,Brazil,1972,male,0,0,2,2
457,Ethiopia,1972,male,0,0,2,2
458,Ghana,1972,male,0,0,1,1
459,Jamaica,1972,male,0,0,1,1
460,New Zealand,1972,male,0,0,1,1
461,Niger,1972,male,0,0,1,1
462,Nigeria,1972,male,0,0,1,1
463,Spain,1972,male,0,0,1,1
464,Soviet Union,1976,male,30,20,19,69
465,United States,1976,male,25,23,17,65
466,East Germany,1976,male,8,7,12,27
467,Japan,1976,male,7,6,10,23
468,Cuba,1976,male,6,4,2,12
469,Poland,1976,male,5,2,12,19
470,West Germany,1976,male,4,6,10,20
471,Finland,1976,male,4,2,0,6
472,Bulgaria,1976,male,3,6,5,14
473,Hungary,1976,male,2,4,5,11
474,Italy,1976,male,2,2,4,8
475,Yugoslavia,1976,male,2,2,3,7
476,Czechoslovakia,1976,male,2,1,1,4
477,Sweden,1976,male,2,0,0,2
478,Romania,1976,male,1,5,9,15
479,France,1976,male,1,2,3,6
480,Great Britain,1976,male,1,2,3,6
481,Republic of Korea,1976,male,1,1,3,5
482,Democratic People's Republic of Korea,1976,male,1,1,0,2
483,Jamaica,1976,male,1,1,0,2
484,New Zealand,1976,male,1,1,0,2
485,Mexico,1976,male,1,0,1,2
486,Trinidad and Tobago,1976,male,1,0,0,1
487,Belgium,1976,male,0,3,2,5
488,Canada,1976,male,0,3,0,3
489,Netherlands,1976,male,0,2,0,2
490,Portugal,1976,male,0,2,0,2
491,Islamic Republic of Iran,1976,male,0,1,1,2
492,Mongolia,1976,male,0,1,0,1
493,Venezuela,1976,male,0,1,0,1
494,Australia,1976,male,0,0,2,2
495,Austria,1976,male,0,0,1,1
496,Bermuda,1976,male,0,0,1,1
497,Brazil,1976,male,0,0,1,1
498,Denmark,1976,male,0,0,1,1
499,Puerto Rico,1976,male,0,0,1,1
500,Switzerland,1976,male,0,0,1,1
501,Thailand,1976,male,0,0,1,1
502,Soviet Union,1980,male,46,44,26,116
503,East Germany,1980,male,14,11,23,48
504,Bulgaria,1980,male,8,10,11,29
505,Cuba,1980,male,7,7,5,19
506,Italy,1980,male,7,0,2,9
507,Hungary,1980,male,6,7,9,22
508,Great Britain,1980,male,5,4,4,13
509,Poland,1980,male,3,9,10,22
510,Sweden,1980,male,3,2,4,9
511,Finland,1980,male,3,1,2,6
512,France,1980,male,2,5,2,9
513,Romania,1980,male,2,1,6,9
514,Ethiopia,1980,male,2,0,2,4
515,Switzerland,1980,male,2,0,0,2
516,Czechoslovakia,1980,male,1,1,6,8
517,Yugoslavia,1980,male,1,0,2,3
518,Denmark,1980,male,1,0,1,2
519,Greece,1980,male,1,0,1,2
520,Belgium,1980,male,1,0,0,1
521,Democratic People's Republic of Korea,1980,male,0,3,2,5
522,Australia,1980,male,0,2,4,6
523,Mongolia,1980,male,0,2,2,4
524,United Republic of Tanzania,1980,male,0,2,0,2
525,Austria,1980,male,0,1,1,2
526,Mexico,1980,male,0,1,1,2
527,Netherlands,1980,male,0,1,1,2
528,Spain,1980,male,0,1,1,2
529,Uganda,1980,male,0,1,0,1
530,Venezuela,1980,male,0,1,0,1
531,Jamaica,1980,male,0,0,2,2
532,Brazil,1980,male,0,0,1,1
533,Guyana,1980,male,0,0,1,1
534,Ireland,1980,male,0,0,1,1
535,Lebanon,1980,male,0,0,1,1
536,United States,1984,male,42,28,19,89
537,West Germany,1984,male,11,9,9,29
538,Japan,1984,male,10,8,10,28
539,People's Republic of China,1984,male,10,6,5,21
540,Italy,1984,male,8,4,8,20
541,Republic of Korea,1984,male,5,4,6,15
542,Canada,1984,male,4,8,8,20
543,Romania,1984,male,4,7,8,19
544,France,1984,male,4,4,8,16
545,Finland,1984,male,4,1,6,11
546,New Zealand,1984,male,4,1,1,6
547,Great Britain,1984,male,3,5,11,19
548,Yugoslavia,1984,male,3,3,4,10
549,Australia,1984,male,2,4,4,10
550,Mexico,1984,male,2,3,1,6
551,Brazil,1984,male,1,2,2,5
552,Austria,1984,male,1,1,1,3
553,Kenya,1984,male,1,0,2,3
554,Netherlands,1984,male,1,0,1,2
555,Portugal,1984,male,1,0,1,2
556,Belgium,1984,male,1,0,0,1
557,Morocco,1984,male,1,0,0,1
558,Sweden,1984,male,0,8,4,12
559,Switzerland,1984,male,0,2,3,5
560,Denmark,1984,male,0,2,1,3
561,Greece,1984,male,0,1,1,2
562,Puerto Rico,1984,male,0,1,1,2
563,Colombia,1984,male,0,1,0,1
564,Côte d'Ivoire,1984,male,0,1,0,1
565,Egypt,1984,male,0,1,0,1
566,Ireland,1984,male,0,1,0,1
567,Nigeria,1984,male,0,1,0,1
568,Peru,1984,male,0,1,0,1
569,Syrian Arab Republic,1984,male,0,1,0,1
570,Thailand,1984,male,0,1,0,1
571,Türkiye,1984,male,0,0,3,3
572,Venezuela,1984,male,0,0,3,3
573,Algeria,1984,male,0,0,2,2
574,Cameroon,1984,male,0,0,1,1
575,Chinese Taipei,1984,male,0,0,1,1
576,Dominican Republic,1984,male,0,0,1,1
577,Iceland,1984,male,0,0,1,1
578,Norway,1984,male,0,0,1,1
579,Spain,1984,male,0,0,1,1
580,Zambia,1984,male,0,0,1,1
581,Soviet Union,1988,male,33,17,26,76
582,United States,1988,male,17,18,14,49
583,East Germany,1988,male,13,14,12,39
584,Republic of Korea,1988,male,7,7,9,23
585,Bulgaria,1988,male,7,6,6,19
586,Hungary,1988,male,7,4,3,14
587,Kenya,1988,male,5,2,2,9
588,Japan,1988,male,4,2,4,10
589,Italy,1988,male,4,2,3,9
590,France,1988,male,3,3,2,8
591,Czechoslovakia,1988,male,3,2,1,6
592,West Germany,1988,male,2,8,8,18
593,Great Britain,1988,male,2,6,4,12
594,Poland,1988,male,2,3,7,12
595,Romania,1988,male,2,2,1,5
596,New Zealand,1988,male,2,0,5,7
597,Norway,1988,male,2,0,0,2
598,Australia,1988,male,1,5,1,7
599,People's Republic of China,1988,male,1,4,7,12
600,Canada,1988,male,1,1,2,4
601,Finland,1988,male,1,1,2,4
602,Brazil,1988,male,1,1,1,3
603,Yugoslavia,1988,male,1,1,1,3
604,Denmark,1988,male,1,1,0,2
605,Türkiye,1988,male,1,1,0,2
606,Morocco,1988,male,1,0,2,3
607,Spain,1988,male,1,0,2,3
608,Austria,1988,male,1,0,0,1
609,Suriname,1988,male,1,0,0,1
610,Sweden,1988,male,0,3,5,8
611,Netherlands,1988,male,0,1,2,3
612,Chile,1988,male,0,1,0,1
613,Islamic Republic of Iran,1988,male,0,1,0,1
614,Netherlands Antilles,1988,male,0,1,0,1
615,Senegal,1988,male,0,1,0,1
616,United States Virgin Islands,1988,male,0,1,0,1
617,Belgium,1988,male,0,0,2,2
618,Mexico,1988,male,0,0,2,2
619,Colombia,1988,male,0,0,1,1
620,Djibouti,1988,male,0,0,1,1
621,Greece,1988,male,0,0,1,1
622,Mongolia,1988,male,0,0,1,1
623,Pakistan,1988,male,0,0,1,1
624,Philippines,1988,male,0,0,1,1
625,Switzerland,1988,male,0,0,1,1
626,Thailand,1988,male,0,0,1,1
627,Unified Team,1992,male,28,22,15,65
628,United States,1992,male,16,18,15,49
629,Germany,1992,male,10,7,14,31
630,Cuba,1992,male,10,3,6,19
631,Hungary,1992,male,6,6,6,18
632,Republic of Korea,1992,male,5,3,7,15
633,Spain,1992,male,5,3,1,9
634,France,1992,male,4,4,7,15
635,Czechoslovakia,1992,male,4,1,1,6
636,Democratic People's Republic of Korea,1992,male,4,0,3,7
637,People's Republic of China,1992,male,3,6,7,16
638,Australia,1992,male,3,4,3,10
639,Bulgaria,1992,male,3,4,3,10
640,Italy,1992,male,3,2,5,10
641,Japan,1992,male,2,4,5,11
642,Poland,1992,male,2,4,5,11
643,Kenya,1992,male,2,4,2,8
644,Canada,1992,male,2,3,3,8
645,Great Britain,1992,male,2,2,5,9
646,Türkiye,1992,male,2,2,1,5
647,Sweden,1992,male,1,3,3,7
648,Norway,1992,male,1,2,1,4
649,Finland,1992,male,1,1,2,4
650,Indonesia,1992,male,1,1,1,3
651,Morocco,1992,male,1,1,1,3
652,Brazil,1992,male,1,1,0,2
653,Ireland,1992,male,1,1,0,2
654,Greece,1992,male,1,0,0,1
655,Lithuania,1992,male,1,0,0,1
656,Switzerland,1992,male,1,0,0,1
657,Netherlands,1992,male,0,4,2,6
658,Latvia,1992,male,0,2,1,3
659,Namibia,1992,male,0,2,0,2
660,Nigeria,1992,male,0,2,0,2
661,New Zealand,1992,male,0,1,4,5
662,Islamic Republic of Iran,1992,male,0,1,2,3
663,Jamaica,1992,male,0,1,0,1
664,Mexico,1992,male,0,1,0,1
665,Peru,1992,male,0,1,0,1
666,Romania,1992,male,0,0,4,4
667,Denmark,1992,male,0,0,2,2
668,Ethiopia,1992,male,0,0,2,2
669,Algeria,1992,male,0,0,1,1
670,Belgium,1992,male,0,0,1,1
671,Croatia,1992,male,0,0,1,1
672,Independent Olympic Athletes,1992,male,0,0,1,1
673,Israel,1992,male,0,0,1,1
674,Mongolia,1992,male,0,0,1,1
675,Philippines,1992,male,0,0,1,1
676,Puerto Rico,1992,male,0,0,1,1
677,Qatar,1992,male,0,0,1,1
678,Suriname,1992,male,0,0,1,1
679,Thailand,1992,male,0,0,1,1
680,The Bahamas,1992,male,0,0,1,1
681,United States,1996,male,18,17,11,46
682,Russian Federation,1996,male,17,8,10,35
683,Germany,1996,male,8,6,15,29
684,Italy,1996,male,7,3,4,14
685,People's Republic of China,1996,male,6,7,5,18
686,Cuba,1996,male,6,6,4,16
687,Poland,1996,male,6,3,3,12
688,France,1996,male,5,3,7,15
689,Greece,1996,male,4,3,0,7
690,Hungary,1996,male,4,2,5,11
691,Türkiye,1996,male,4,1,1,6
692,Ukraine,1996,male,4,0,7,11
693,Kazakhstan,1996,male,3,4,4,11
694,Australia,1996,male,3,2,7,12
695,Switzerland,1996,male,3,2,0,5
696,Czechia,1996,male,3,1,2,6
697,New Zealand,1996,male,3,0,0,3
698,Republic of Korea,1996,male,2,8,2,12
699,Bulgaria,1996,male,2,5,3,10
700,Japan,1996,male,2,2,2,6
701,Norway,1996,male,2,1,1,4
702,Algeria,1996,male,2,0,1,3
703,Canada,1996,male,1,4,3,8
704,Spain,1996,male,1,4,2,7
705,Kenya,1996,male,1,3,3,7
706,Brazil,1996,male,1,1,4,6
707,Democratic People's Republic of Korea,1996,male,1,1,2,4
708,Belgium,1996,male,1,1,1,3
709,Islamic Republic of Iran,1996,male,1,1,1,3
710,Slovakia,1996,male,1,1,1,3
711,Armenia,1996,male,1,1,0,2
712,Denmark,1996,male,1,1,0,2
713,South Africa,1996,male,1,1,0,2
714,Netherlands,1996,male,1,0,3,4
715,Thailand,1996,male,1,0,1,2
716,Burundi,1996,male,1,0,0,1
717,Ecuador,1996,male,1,0,0,1
718,Ethiopia,1996,male,1,0,0,1
719,Belarus,1996,male,0,5,6,11
720,Great Britain,1996,male,0,5,4,9
721,Romania,1996,male,0,2,3,5
722,Finland,1996,male,0,2,1,3
723,Namibia,1996,male,0,2,0,2
724,Argentina,1996,male,0,1,1,2
725,Austria,1996,male,0,1,1,2
726,Sweden,1996,male,0,1,1,2
727,Uzbekistan,1996,male,0,1,1,2
728,Azerbaijan,1996,male,0,1,0,1
729,Jamaica,1996,male,0,1,0,1
730,Latvia,1996,male,0,1,0,1
731,Philippines,1996,male,0,1,0,1
732,Slovenia,1996,male,0,1,0,1
733,Tonga,1996,male,0,1,0,1
734,Zambia,1996,male,0,1,0,1
735,Georgia,1996,male,0,0,2,2
736,Morocco,1996,male,0,0,2,2
737,Trinidad and Tobago,1996,male,0,0,2,2
738,India,1996,male,0,0,1,1
739,Israel,1996,male,0,0,1,1
740,Malaysia,1996,male,0,0,1,1
741,Mexico,1996,male,0,0,1,1
742,Mongolia,1996,male,0,0,1,1
743,Nigeria,1996,male,0,0,1,1
744,Puerto Rico,1996,male,0,0,1,1
745,Republic of Moldova,1996,male,0,0,1,1
746,Tunisia,1996,male,0,0,1,1
747,Uganda,1996,male,0,0,1,1
748,Russian Federation,2000,male,17,10,19,46
749,United States,2000,male,15,13,13,41
750,Cuba,2000,male,8,6,4,18
751,People's Republic of China,2000,male,8,4,5,17
752,France,2000,male,6,6,5,17
753,Great Britain,2000,male,6,4,1,11
754,Germany,2000,male,5,10,8,23
755,Australia,2000,male,4,10,6,20
756,Italy,2000,male,4,3,6,13
757,Greece,2000,male,4,3,1,8
758,Netherlands,2000,male,4,1,2,7
759,Republic of Korea,2000,male,3,6,3,12
760,Bulgaria,2000,male,3,5,2,10
761,Japan,2000,male,3,2,0,5
762,Poland,2000,male,3,1,1,5
763,Sweden,2000,male,3,1,1,5
764,Ethiopia,2000,male,3,0,2,5
765,Islamic Republic of Iran,2000,male,3,0,1,4
766,Türkiye,2000,male,3,0,1,4
767,Kazakhstan,2000,male,2,4,0,6
768,Kenya,2000,male,2,3,1,6
769,Hungary,2000,male,2,2,1,5
770,Spain,2000,male,2,2,0,4
771,Canada,2000,male,2,1,3,6
772,Romania,2000,male,2,1,2,5
773,Norway,2000,male,2,0,1,3
774,Ukraine,2000,male,1,5,6,12
775,Czechia,2000,male,1,3,2,6
776,Uzbekistan,2000,male,1,1,2,4
777,Finland,2000,male,1,1,1,3
778,Latvia,2000,male,1,1,1,3
779,Estonia,2000,male,1,0,2,3
780,New Zealand,2000,male,1,0,2,3
781,Azerbaijan,2000,male,1,0,1,2
782,Thailand,2000,male,1,0,1,2
783,Austria,2000,male,1,0,0,1
784,Croatia,2000,male,1,0,0,1
785,Lithuania,2000,male,1,0,0,1
786,Slovenia,2000,male,1,0,0,1
787,Brazil,2000,male,0,3,0,3
788,Mexico,2000,male,0,2,3,5
789,Switzerland,2000,male,0,2,1,3
790,Denmark,2000,male,0,2,0,2
791,Belarus,2000,male,0,1,8,9
792,Algeria,2000,male,0,1,3,4
793,Morocco,2000,male,0,1,3,4
794,South Africa,2000,male,0,1,2,3
795,Kingdom of Saudi Arabia,2000,male,0,1,1,2
796,Republic of Moldova,2000,male,0,1,1,2
797,Slovakia,2000,male,0,1,1,2
798,Trinidad and Tobago,2000,male,0,1,1,2
799,Argentina,2000,male,0,1,0,1
800,Belgium,2000,male,0,1,0,1
801,Indonesia,2000,male,0,1,0,1
802,Uruguay,2000,male,0,1,0,1
803,Georgia,2000,male,0,0,6,6
804,Democratic People's Republic of Korea,2000,male,0,0,2,2
805,Armenia,2000,male,0,0,1,1
806,Barbados,2000,male,0,0,1,1
807,Chinese Taipei,2000,male,0,0,1,1
808,Israel,2000,male,0,0,1,1
809,Jamaica,2000,male,0,0,1,1
810,Kuwait,2000,male,0,0,1,1
811,Kyrgyzstan,2000,male,0,0,1,1
812,North Macedonia,2000,male,0,0,1,1
813,Portugal,2000,male,0,0,1,1
814,Qatar,2000,male,0,0,1,1
815,United States,2004,male,18,20,9,47
816,Russian Federation,2004,male,15,9,19,43
817,People's Republic of China,2004,male,9,5,5,19
818,Italy,2004,male,7,2,4,13
819,Japan,2004,male,6,4,5,15
820,Cuba,2004,male,6,3,5,14
821,Australia,2004,male,5,4,6,15
822,Republic of Korea,2004,male,4,6,5,15
823,France,2004,male,4,2,4,10
824,Great Britain,2004,male,4,2,4,10
825,Germany,2004,male,3,2,9,14
826,Ukraine,2004,male,3,2,2,7
827,Norway,2004,male,3,0,0,3
828,Spain,2004,male,2,6,3,11
829,Türkiye,2004,male,2,3,4,9
830,Greece,2004,male,2,2,2,6
831,Islamic Republic of Iran,2004,male,2,2,2,6
832,Georgia,2004,male,2,2,0,4
833,Uzbekistan,2004,male,2,1,2,5
834,Canada,2004,male,2,1,1,4
835,Sweden,2004,male,2,1,0,3
836,Brazil,2004,male,2,0,3,5
837,Morocco,2004,male,2,0,0,2
838,Kazakhstan,2004,male,1,4,3,8
839,Belarus,2004,male,1,3,2,6
840,Hungary,2004,male,1,3,2,6
841,Netherlands,2004,male,1,2,3,6
842,Kenya,2004,male,1,2,2,5
843,Ethiopia,2004,male,1,2,0,3
844,New Zealand,2004,male,1,2,0,3
845,Bulgaria,2004,male,1,1,6,8
846,Egypt,2004,male,1,1,3,5
847,Thailand,2004,male,1,1,1,3
848,Chinese Taipei,2004,male,1,1,0,2
849,Lithuania,2004,male,1,1,0,2
850,Azerbaijan,2004,male,1,0,2,3
851,Czechia,2004,male,1,0,2,3
852,Chile,2004,male,1,0,1,2
853,Indonesia,2004,male,1,0,1,2
854,Israel,2004,male,1,0,1,2
855,Poland,2004,male,1,0,1,2
856,Switzerland,2004,male,1,0,1,2
857,Dominican Republic,2004,male,1,0,0,1
858,United Arab Emirates,2004,male,1,0,0,1
859,Romania,2004,male,0,3,3,6
860,Austria,2004,male,0,3,1,4
861,Latvia,2004,male,0,3,0,3
862,Portugal,2004,male,0,2,1,3
863,Slovakia,2004,male,0,2,1,3
864,South Africa,2004,male,0,2,1,3
865,Finland,2004,male,0,2,0,2
866,Estonia,2004,male,0,1,2,3
867,Croatia,2004,male,0,1,1,2
868,Democratic People's Republic of Korea,2004,male,0,1,1,2
869,Denmark,2004,male,0,1,1,2
870,India,2004,male,0,1,0,1
871,Jamaica,2004,male,0,1,0,1
872,Mexico,2004,male,0,1,0,1
873,Belgium,2004,male,0,0,1,1
874,Eritrea,2004,male,0,0,1,1
875,Mongolia,2004,male,0,0,1,1
876,Slovenia,2004,male,0,0,1,1
877,Syrian Arab Republic,2004,male,0,0,1,1
878,Trinidad and Tobago,2004,male,0,0,1,1
879,Venezuela,2004,male,0,0,1,1
880,People's Republic of China,2008,male,19,9,8,36
881,United States,2008,male,13,12,17,42
882,Russian Federation,2008,male,13,3,14,30
883,Great Britain,2008,male,7,6,6,19
884,Republic of Korea,2008,male,6,6,2,14
885,Germany,2008,male,6,3,3,12
886,Italy,2008,male,4,4,3,11
887,Japan,2008,male,4,4,2,10
888,Ukraine,2008,male,4,2,6,12
889,Kenya,2008,male,4,1,4,9
890,France,2008,male,3,12,12,27
891,Australia,2008,male,3,4,6,13
892,Spain,2008,male,3,3,1,7
893,Georgia,2008,male,3,2,1,6
894,Poland,2008,male,3,1,1,5
895,Cuba,2008,male,2,4,13,19
896,Norway,2008,male,2,3,0,5
897,Ethiopia,2008,male,2,1,1,4
898,Mongolia,2008,male,2,1,0,3
899,Jamaica,2008,male,2,0,0,2
900,Canada,2008,male,1,4,3,8
901,Hungary,2008,male,1,4,0,5
902,Belarus,2008,male,1,3,2,6
903,Kazakhstan,2008,male,1,2,3,6
904,New Zealand,2008,male,1,2,2,5
905,Azerbaijan,2008,male,1,1,3,5
906,Switzerland,2008,male,1,1,2,4
907,Czechia,2008,male,1,1,1,3
908,Latvia,2008,male,1,1,1,3
909,Slovenia,2008,male,1,1,1,3
910,Dominican Republic,2008,male,1,1,0,2
911,Slovakia,2008,male,1,1,0,2
912,Thailand,2008,male,1,1,0,2
913,Brazil,2008,male,1,0,3,4
914,Türkiye,2008,male,1,0,3,4
915,India,2008,male,1,0,2,3
916,Netherlands,2008,male,1,0,2,3
917,Islamic Republic of Iran,2008,male,1,0,1,2
918,Estonia,2008,male,1,0,0,1
919,Mexico,2008,male,1,0,0,1
920,Panama,2008,male,1,0,0,1
921,Portugal,2008,male,1,0,0,1
922,Tunisia,2008,male,1,0,0,1
923,Lithuania,2008,male,0,2,2,4
924,Sweden,2008,male,0,2,0,2
925,Armenia,2008,male,0,1,4,5
926,Ireland,2008,male,0,1,2,3
927,Kyrgyzstan,2008,male,0,1,2,3
928,Uzbekistan,2008,male,0,1,2,3
929,Serbia,2008,male,0,1,1,2
930,Tajikistan,2008,male,0,1,1,2
931,Algeria,2008,male,0,1,0,1
932,Austria,2008,male,0,1,0,1
933,Chile,2008,male,0,1,0,1
934,Colombia,2008,male,0,1,0,1
935,Croatia,2008,male,0,1,0,1
936,Ecuador,2008,male,0,1,0,1
937,Greece,2008,male,0,1,0,1
938,Malaysia,2008,male,0,1,0,1
939,Morocco,2008,male,0,1,0,1
940,South Africa,2008,male,0,1,0,1
941,Sudan,2008,male,0,1,0,1
942,Trinidad and Tobago,2008,male,0,1,0,1
943,Vietnam,2008,male,0,1,0,1
944,Bulgaria,2008,male,0,0,3,3
945,Chinese Taipei,2008,male,0,0,2,2
946,Finland,2008,male,0,0,2,2
947,Indonesia,2008,male,0,0,2,2
948,Romania,2008,male,0,0,2,2
949,Afghanistan,2008,male,0,0,1,1
950,Democratic People's Republic of Korea,2008,male,0,0,1,1
951,Egypt,2008,male,0,0,1,1
952,Israel,2008,male,0,0,1,1
953,Mauritius,2008,male,0,0,1,1
954,Nigeria,2008,male,0,0,1,1
955,Republic of Moldova,2008,male,0,0,1,1
956,The Bahamas,2008,male,0,0,1,1
957,Togo,2008,male,0,0,1,1
958,United States,2012,male,14,10,11,35
959,Great Britain,2012,male,13,5,8,26
960,People's Republic of China,2012,male,12,9,9,30
961,Russian Federation,2012,male,9,7,11,27
962,Republic of Korea,2012,male,7,7,3,17
963,Islamic Republic of Iran,2012,male,7,5,1,13
964,France,2012,male,5,3,4,12
965,Hungary,2012,male,4,2,4,10
966,Cuba,2012,male,4,1,6,11
967,Germany,2012,male,3,10,6,19
968,Italy,2012,male,3,6,5,14
969,Japan,2012,male,3,5,10,18
970,Ukraine,2012,male,3,2,3,8
971,Australia,2012,male,2,4,1,7
972,Jamaica,2012,male,2,2,2,6
973,Czechia,2012,male,2,2,1,5
974,Azerbaijan,2012,male,2,1,4,7
975,Kazakhstan,2012,male,2,1,4,7
976,Kenya,2012,male,2,1,4,7
977,Poland,2012,male,2,1,3,6
978,Netherlands,2012,male,2,1,2,5
979,South Africa,2012,male,2,1,0,3
980,Democratic People's Republic of Korea,2012,male,2,0,2,4
981,Spain,2012,male,1,4,1,6
982,Brazil,2012,male,1,2,4,7
983,Georgia,2012,male,1,2,3,6
984,Denmark,2012,male,1,2,0,3
985,Switzerland,2012,male,1,2,0,3
986,Norway,2012,male,1,1,1,3
987,Dominican Republic,2012,male,1,1,0,2
988,Argentina,2012,male,1,0,1,2
989,New Zealand,2012,male,1,0,1,2
990,Trinidad and Tobago,2012,male,1,0,1,2
991,Tunisia,2012,male,1,0,1,2
992,Türkiye,2012,male,1,0,1,2
993,Algeria,2012,male,1,0,0,1
994,Belarus,2012,male,1,0,0,1
995,Croatia,2012,male,1,0,0,1
996,Grenada,2012,male,1,0,0,1
997,Latvia,2012,male,1,0,0,1
998,Romania,2012,male,1,0,0,1
999,Uganda,2012,male,1,0,0,1
1000,Venezuela,2012,male,1,0,0,1
1001,Canada,2012,male,0,3,5,8
1002,Colombia,2012,male,0,2,2,4
1003,India,2012,male,0,2,2,4
1004,Mongolia,2012,male,0,2,2,4
1005,Egypt,2012,male,0,2,1,3
1006,Ireland,2012,male,0,1,4,5
1007,Sweden,2012,male,0,1,3,4
1008,Armenia,2012,male,0,1,1,2
1009,Estonia,2012,male,0,1,1,2
1010,Ethiopia,2012,male,0,1,1,2
1011,Indonesia,2012,male,0,1,1,2
1012,Puerto Rico,2012,male,0,1,1,2
1013,Qatar,2012,male,0,1,1,2
1014,Slovenia,2012,male,0,1,1,2
1015,Belgium,2012,male,0,1,0,1
1016,Botswana,2012,male,0,1,0,1
1017,Cyprus,2012,male,0,1,0,1
1018,Finland,2012,male,0,1,0,1
1019,Gabon,2012,male,0,1,0,1
1020,Guatemala,2012,male,0,1,0,1
1021,Malaysia,2012,male,0,1,0,1
1022,Thailand,2012,male,0,1,0,1
1023,Uzbekistan,2012,male,0,0,3,3
1024,Lithuania,2012,male,0,0,2,2
1025,Afghanistan,2012,male,0,0,1,1
1026,Bulgaria,2012,male,0,0,1,1
1027,Greece,2012,male,0,0,1,1
1028,Kuwait,2012,male,0,0,1,1
1029,Morocco,2012,male,0,0,1,1
1030,Serbia,2012,male,0,0,1,1
1031,Slovakia,2012,male,0,0,1,1
1032,Vietnam,2012,male,0,0,1,1
1033,Great Britain,2016,male,14,8,7,29
1034,United States,2016,male,13,15,17,45
1035,People's Republic of China,2016,male,9,7,7,23
1036,Russian Federation,2016,male,8,4,13,25
1037,Italy,2016,male,7,2,3,12
1038,Germany,2016,male,7,0,5,12
1039,Cuba,2016,male,5,1,3,9
1040,Japan,2016,male,4,5,10,19
1041,Uzbekistan,2016,male,4,2,7,13
1042,France,2016,male,3,8,10,21
1043,Kenya,2016,male,3,3,0,6
1044,Republic of Korea,2016,male,3,2,6,11
1045,Australia,2016,male,3,2,1,6
1046,Islamic Republic of Iran,2016,male,3,1,3,7
1047,Jamaica,2016,male,3,0,0,3
1048,Brazil,2016,male,2,4,4,10
1049,Ukraine,2016,male,2,4,1,7
1050,Kazakhstan,2016,male,2,3,4,9
1051,Netherlands,2016,male,2,3,0,5
1052,Georgia,2016,male,2,1,4,7
1053,Switzerland,2016,male,2,0,0,2
1054,Azerbaijan,2016,male,1,6,7,14
1055,South Africa,2016,male,1,4,1,6
1056,Türkiye,2016,male,1,3,3,7
1057,Armenia,2016,male,1,3,0,4
1058,Belarus,2016,male,1,2,2,5
1059,Czechia,2016,male,1,2,2,5
1060,Croatia,2016,male,1,2,1,4
1061,Hungary,2016,male,1,2,1,4
1062,Canada,2016,male,1,1,3,5
1063,Spain,2016,male,1,1,3,5
1064,Colombia,2016,male,1,1,2,4
1065,Belgium,2016,male,1,1,1,3
1066,Democratic People's Republic of Korea,2016,male,1,1,1,3
1067,Greece,2016,male,1,1,0,2
1068,Slovakia,2016,male,1,1,0,2
1069,Vietnam,2016,male,1,1,0,2
1070,New Zealand,2016,male,1,0,3,4
1071,Independent Olympic Athletes,2016,male,1,0,1,2
1072,Côte d'Ivoire,2016,male,1,0,0,1
1073,Jordan,2016,male,1,0,0,1
1074,Serbia,2016,male,1,0,0,1
1075,Singapore,2016,male,1,0,0,1
1076,Tajikistan,2016,male,1,0,0,1
1077,Sweden,2016,male,0,3,0,3
1078,Denmark,2016,male,0,2,2,4
1079,Algeria,2016,male,0,2,0,2
1080,Slovenia,2016,male,0,2,0,2
1081,Ethiopia,2016,male,0,1,2,3
1082,Mexico,2016,male,0,1,2,3
1083,Poland,2016,male,0,1,2,3
1084,Malaysia,2016,male,0,1,1,2
1085,Thailand,2016,male,0,1,1,2
1086,Argentina,2016,male,0,1,0,1
1087,Grenada,2016,male,0,1,0,1
1088,Indonesia,2016,male,0,1,0,1
1089,Niger,2016,male,0,1,0,1
1090,Qatar,2016,male,0,1,0,1
1091,Venezuela,2016,male,0,1,0,1
1092,Dominican Republic,2016,male,0,0,1,1
1093,Egypt,2016,male,0,0,1,1
1094,Israel,2016,male,0,0,1,1
1095,Lithuania,2016,male,0,0,1,1
1096,Mongolia,2016,male,0,0,1,1
1097,Morocco,2016,male,0,0,1,1
1098,Norway,2016,male,0,0,1,1
1099,Romania,2016,male,0,0,1,1
1100,Trinidad and Tobago,2016,male,0,0,1,1
1101,Tunisia,2016,male,0,0,1,1
1102,United Arab Emirates,2016,male,0,0,1,1
1103,United States,2020,male,12,13,9,34
1104,People's Republic of China,2020,male,11,10,7,28
1105,Great Britain,2020,male,10,8,9,27
1106,Japan,2020,male,10,4,6,20
1107,ROC,2020,male,9,5,13,27
1108,Cuba,2020,male,6,2,4,12
1109,Hungary,2020,male,5,6,2,13
1110,Italy,2020,male,5,5,7,17
1111,Australia,2020,male,4,2,6,12
1112,Netherlands,2020,male,3,5,2,10
1113,Czechia,2020,male,3,3,2,8
1114,France,2020,male,3,3,2,8
1115,Brazil,2020,male,3,2,6,11
1116,Islamic Republic of Iran,2020,male,3,2,2,7
1117,Norway,2020,male,3,2,1,6
1118,Uzbekistan,2020,male,3,0,2,5
1119,Georgia,2020,male,2,5,1,8
1120,Germany,2020,male,2,3,6,11
1121,Kenya,2020,male,2,2,1,5
1122,Sweden,2020,male,2,2,0,4
1123,Canada,2020,male,2,1,2,5
1124,Poland,2020,male,2,0,3,5
1125,Greece,2020,male,2,0,1,3
1126,Slovenia,2020,male,2,0,1,3
1127,Qatar,2020,male,2,0,0,2
1128,Ukraine,2020,male,1,3,3,7
1129,Spain,2020,male,1,2,3,6
1130,Republic of Korea,2020,male,1,1,6,8
1131,Türkiye,2020,male,1,1,6,8
1132,Belarus,2020,male,1,1,1,3
1133,India,2020,male,1,1,1,3
1134,Uganda,2020,male,1,1,1,3
1135,Denmark,2020,male,1,1,0,2
1136,Ethiopia,2020,male,1,1,0,2
1137,Tunisia,2020,male,1,1,0,2
1138,Portugal,2020,male,1,0,2,3
1139,Jamaica,2020,male,1,0,1,2
1140,Ecuador,2020,male,1,0,0,1
1141,"Hong Kong, China",2020,male,1,0,0,1
1142,Israel,2020,male,1,0,0,1
1143,Morocco,2020,male,1,0,0,1
1144,The Bahamas,2020,male,1,0,0,1
1145,Venezuela,2020,male,0,3,0,3
1146,Armenia,2020,male,0,2,2,4
1147,Azerbaijan,2020,male,0,2,2,4
1148,Croatia,2020,male,0,2,2,4
1149,Chinese Taipei,2020,male,0,2,1,3
1150,Colombia,2020,male,0,2,1,3
1151,Slovakia,2020,male,0,2,0,2
1152,New Zealand,2020,male,0,1,4,5
1153,Belgium,2020,male,0,1,2,3
1154,Egypt,2020,male,0,1,2,3
1155,Indonesia,2020,male,0,1,2,3
1156,Serbia,2020,male,0,1,2,3
1157,Switzerland,2020,male,0,1,2,3
1158,Jordan,2020,male,0,1,1,2
1159,Mongolia,2020,male,0,1,1,2
1160,Philippines,2020,male,0,1,1,2
1161,Dominican Republic,2020,male,0,1,0,1
1162,Kingdom of Saudi Arabia,2020,male,0,1,0,1
1163,Kyrgyzstan,2020,male,0,1,0,1
1164,Malaysia,2020,male,0,1,0,1
1165,North Macedonia,2020,male,0,1,0,1
1166,Kazakhstan,2020,male,0,0,6,6
1167,Austria,2020,male,0,0,3,3
1168,Burkina Faso,2020,male,0,0,1,1
1169,Finland,2020,male,0,0,1,1
1170,Ghana,2020,male,0,0,1,1
1171,Grenada,2020,male,0,0,1,1
1172,Ireland,2020,male,0,0,1,1
1173,Kuwait,2020,male,0,0,1,1
1174,Latvia,2020,male,0,0,1,1
1175,Republic of Moldova,2020,male,0,0,1,1
1176,San Marino,2020,male,0,0,1,1
1177,Syrian Arab Republic,2020,male,0,0,1,1
1178,United States,1896,female,17,16,18,51
1179,People's Republic of China,1896,female,15,13,7,35
1180,Japan,1896,female,13,6,8,27
1181,Australia,1896,female,7,2,7,16
1182,Germany,1896,female,5,2,3,10
1183,ROC,1896,female,4,10,6,20
1184,Great Britain,1896,female,4,6,8,18
1185,Netherlands,1896,female,4,3,9,16
1186,Canada,1896,female,3,3,4,10
1187,Switzerland,1896,female,3,2,3,8
1188,New Zealand,1896,female,3,1,2,6
1189,Brazil,1896,female,2,3,1,6
1190,Kenya,1896,female,2,2,1,5
1191,Bulgaria,1896,female,2,1,2,5
1192,Jamaica,1896,female,2,1,2,5
1193,Serbia,1896,female,2,0,1,3
1194,Belgium,1896,female,2,0,0,2
1195,Kosovo,1896,female,2,0,0,2
1196,France,1896,female,1,4,3,8
1197,Italy,1896,female,1,3,7,11
1198,Spain,1896,female,1,3,1,5
1199,Republic of Korea,1896,female,1,2,1,4
1200,South Africa,1896,female,1,2,0,3
1201,Chinese Taipei,1896,female,1,1,4,6
1202,Türkiye,1896,female,1,1,3,5
1203,Austria,1896,female,1,1,2,4
1204,Poland,1896,female,1,1,1,3
1205,Ecuador,1896,female,1,1,0,2
1206,Philippines,1896,female,1,1,0,2
1207,Slovenia,1896,female,1,1,0,2
1208,Denmark,1896,female,1,0,3,4
1209,Egypt,1896,female,1,0,2,3
1210,Israel,1896,female,1,0,1,2
1211,Thailand,1896,female,1,0,1,2
1212,Bermuda,1896,female,1,0,0,1
1213,Croatia,1896,female,1,0,0,1
1214,Ireland,1896,female,1,0,0,1
1215,Puerto Rico,1896,female,1,0,0,1
1216,Slovakia,1896,female,1,0,0,1
1217,The Bahamas,1896,female,1,0,0,1
1218,Uganda,1896,female,1,0,0,1
1219,Venezuela,1896,female,1,0,0,1
1220,Ukraine,1896,female,0,2,6,8
1221,"Hong Kong, China",1896,female,0,2,2,4
1222,Colombia,1896,female,0,2,0,2
1223,Sweden,1896,female,0,2,0,2
1224,Azerbaijan,1896,female,0,1,2,3
1225,Belarus,1896,female,0,1,2,3
1226,India,1896,female,0,1,2,3
1227,Cuba,1896,female,0,1,1,2
1228,Dominican Republic,1896,female,0,1,1,2
1229,Hungary,1896,female,0,1,1,2
1230,Kyrgyzstan,1896,female,0,1,1,2
1231,Nigeria,1896,female,0,1,1,2
1232,Bahrain,1896,female,0,1,0,1
1233,Czechia,1896,female,0,1,0,1
1234,Lithuania,1896,female,0,1,0,1
1235,Namibia,1896,female,0,1,0,1
1236,Portugal,1896,female,0,1,0,1
1237,Romania,1896,female,0,1,0,1
1238,Turkmenistan,1896,female,0,1,0,1
1239,Ethiopia,1896,female,0,0,2,2
1240,Kazakhstan,1896,female,0,0,2,2
1241,Mongolia,1896,female,0,0,2,2
1242,Côte d'Ivoire,1896,female,0,0,1,1
1243,Estonia,1896,female,0,0,1,1
1244,Finland,1896,female,0,0,1,1
1245,Indonesia,1896,female,0,0,1,1
1246,Mexico,1896,female,0,0,1,1
1247,San Marino,1896,female,0,0,1,1
1248,United States,1900,female,1,0,1,2
1249,Great Britain,1900,female,1,0,0,1
1250,France,1900,female,0,1,1,2
1251,Switzerland,1900,female,0,1,0,1
1252,Bohemia,1900,female,0,0,1,1
1253,United States,1904,female,2,2,2,6
1254,Great Britain,1908,female,4,3,3,10
1255,Germany,1908,female,0,1,0,1
1256,Sweden,1908,female,0,0,1,1
1257,Australasia,1912,female,1,1,0,2
1258,Sweden,1912,female,1,1,0,2
1259,Great Britain,1912,female,1,0,3,4
1260,France,1912,female,1,0,0,1
1261,Denmark,1912,female,0,1,0,1
1262,Germany,1912,female,0,1,0,1
1263,Norway,1912,female,0,0,1,1
1264,United States,1920,female,3,3,4,10
1265,Sweden,1920,female,1,1,1,3
1266,France,1920,female,1,1,0,2
1267,Denmark,1920,female,1,0,0,1
1268,Great Britain,1920,female,0,2,1,3
1269,United States,1924,female,6,5,4,15
1270,Great Britain,1924,female,1,3,2,6
1271,Denmark,1924,female,1,0,1,2
1272,France,1924,female,0,1,0,1
1273,Sweden,1924,female,0,0,1,1
1274,United States,1928,female,5,4,3,12
1275,Germany,1928,female,3,0,3,6
1276,Netherlands,1928,female,1,3,0,4
1277,Canada,1928,female,1,1,1,3
1278,Poland,1928,female,1,0,0,1
1279,Great Britain,1928,female,0,3,2,5
1280,Japan,1928,female,0,1,0,1
1281,Sweden,1928,female,0,0,3,3
1282,United States,1932,female,9,7,4,20
1283,Poland,1932,female,1,1,1,3
1284,Australia,1932,female,1,1,0,2
1285,Austria,1932,female,1,0,0,1
1286,Canada,1932,female,0,1,1,2
1287,Germany,1932,female,0,1,1,2
1288,Great Britain,1932,female,0,1,1,2
1289,Japan,1932,female,0,1,0,1
1290,Netherlands,1932,female,0,1,0,1
1291,South Africa,1932,female,0,0,2,2
1292,Denmark,1932,female,0,0,1,1
1293,Hungary,1932,female,0,0,1,1
1294,United States,1936,female,3,2,3,8
1295,Netherlands,1936,female,3,1,0,4
1296,Germany,1936,female,2,4,5,11
1297,Hungary,1936,female,2,0,0,2
1298,Italy,1936,female,1,0,0,1
1299,Japan,1936,female,1,0,0,1
1300,Poland,1936,female,0,2,1,3
1301,Denmark,1936,female,0,1,1,2
1302,Argentina,1936,female,0,1,0,1
1303,Great Britain,1936,female,0,1,0,1
1304,Austria,1936,female,0,0,1,1
1305,Canada,1936,female,0,0,1,1
1306,United States,1948,female,4,4,2,10
1307,Netherlands,1948,female,4,1,1,6
1308,Denmark,1948,female,3,2,2,7
1309,France,1948,female,2,0,2,4
1310,Hungary,1948,female,2,0,2,4
1311,Finland,1948,female,1,1,0,2
1312,Austria,1948,female,1,0,3,4
1313,Great Britain,1948,female,0,4,2,6
1314,Italy,1948,female,0,2,0,2
1315,Australia,1948,female,0,1,3,4
1316,Argentina,1948,female,0,1,0,1
1317,Ireland,1948,female,0,0,1,1
1318,Sweden,1948,female,0,0,1,1
1319,Soviet Union,1952,female,5,9,7,21
1320,Hungary,1952,female,5,3,5,13
1321,Australia,1952,female,3,0,1,4
1322,United States,1952,female,2,1,3,6
1323,South Africa,1952,female,2,1,0,3
1324,New Zealand,1952,female,1,0,1,2
1325,Czechoslovakia,1952,female,1,0,0,1
1326,Finland,1952,female,1,0,0,1
1327,Italy,1952,female,1,0,0,1
1328,Netherlands,1952,female,0,3,0,3
1329,Great Britain,1952,female,0,1,2,3
1330,Denmark,1952,female,0,1,1,2
1331,Germany,1952,female,0,1,1,2
1332,Austria,1952,female,0,1,0,1
1333,France,1952,female,0,1,0,1
1334,Soviet Union,1956,female,6,6,5,17
1335,Australia,1956,female,5,2,4,11
1336,United States,1956,female,4,5,3,12
1337,Hungary,1956,female,3,2,1,6
1338,Great Britain,1956,female,2,1,1,4
1339,Germany,1956,female,1,4,2,7
1340,Czechoslovakia,1956,female,1,1,0,2
1341,Poland,1956,female,1,0,0,1
1342,Romania,1956,female,0,1,1,2
1343,Chile,1956,female,0,1,0,1
1344,Canada,1956,female,0,0,1,1
1345,Denmark,1956,female,0,0,1,1
1346,France,1956,female,0,0,1,1
1347,Sweden,1956,female,0,0,1,1
1348,Soviet Union,1960,female,11,7,7,25
1349,United States,1960,female,5,3,1,9
1350,Germany,1960,female,3,4,4,11
1351,Great Britain,1960,female,1,4,3,8
1352,Australia,1960,female,1,1,1,3
1353,Czechoslovakia,1960,female,1,1,0,2
1354,Romania,1960,female,1,0,2,3
1355,Poland,1960,female,0,2,1,3
1356,Netherlands,1960,female,0,1,1,2
1357,Sweden,1960,female,0,1,0,1
1358,Italy,1960,female,0,0,1,1
1359,Japan,1960,female,0,0,1,1
1360,United States,1964,female,7,6,7,20
1361,Soviet Union,1964,female,7,4,10,21
1362,Czechoslovakia,1964,female,3,0,0,3
1363,Germany,1964,female,2,5,0,7
1364,Great Britain,1964,female,2,2,0,4
1365,Australia,1964,female,2,1,3,6
1366,Romania,1964,female,2,1,1,4
1367,Hungary,1964,female,1,2,1,4
1368,Poland,1964,female,0,3,1,4
1369,France,1964,female,0,2,0,2
1370,Netherlands,1964,female,0,1,0,1
1371,Italy,1964,female,0,0,1,1
1372,New Zealand,1964,female,0,0,1,1
1373,United States,1968,female,12,8,10,30
1374,Czechoslovakia,1968,female,6,1,0,7
1375,Soviet Union,1968,female,4,5,10,19
1376,Australia,1968,female,2,2,2,6
1377,Romania,1968,female,2,2,1,5
1378,East Germany,1968,female,1,4,1,6
1379,West Germany,1968,female,1,2,0,3
1380,Yugoslavia,1968,female,1,1,0,2
1381,Hungary,1968,female,1,0,3,4
1382,Netherlands,1968,female,1,0,1,2
1383,Poland,1968,female,1,0,1,2
1384,France,1968,female,1,0,0,1
1385,Great Britain,1968,female,0,3,0,3
1386,Canada,1968,female,0,2,0,2
1387,Austria,1968,female,0,1,1,2
1388,Mexico,1968,female,0,1,1,2
1389,Chinese Taipei,1968,female,0,0,1,1
1390,East Germany,1972,female,8,8,7,23
1391,United States,1972,female,8,5,6,19
1392,Soviet Union,1972,female,7,6,6,19
1393,Australia,1972,female,5,3,2,10
1394,West Germany,1972,female,4,3,1,8
1395,Italy,1972,female,1,1,3,5
1396,Great Britain,1972,female,1,1,0,2
1397,Sweden,1972,female,1,1,0,2
1398,Japan,1972,female,1,0,0,1
1399,Bulgaria,1972,female,0,2,2,4
1400,Hungary,1972,female,0,2,2,4
1401,Romania,1972,female,0,2,0,2
1402,Canada,1972,female,0,1,1,2
1403,Czechoslovakia,1972,female,0,1,1,2
1404,Poland,1972,female,0,1,1,2
1405,Netherlands,1972,female,0,1,0,1
1406,Austria,1972,female,0,0,1,1
1407,Cuba,1972,female,0,0,1,1
1408,East Germany,1976,female,19,11,7,37
1409,Soviet Union,1976,female,6,10,8,24
1410,Romania,1976,female,3,1,2,6
1411,United States,1976,female,2,6,5,13
1412,Bulgaria,1976,female,1,2,1,4
1413,West Germany,1976,female,1,2,1,4
1414,Hungary,1976,female,1,0,2,3
1415,Poland,1976,female,1,0,0,1
1416,Switzerland,1976,female,1,0,0,1
1417,Italy,1976,female,0,2,0,2
1418,Canada,1976,female,0,1,4,5
1419,Sweden,1976,female,0,1,0,1
1420,Netherlands,1976,female,0,0,2,2
1421,Czechoslovakia,1976,female,0,0,1,1
1422,East Germany,1980,female,16,15,16,47
1423,Soviet Union,1980,female,12,11,11,34
1424,Romania,1980,female,3,2,2,7
1425,Australia,1980,female,1,0,1,2
1426,Austria,1980,female,1,0,0,1
1427,Cuba,1980,female,1,0,0,1
1428,France,1980,female,1,0,0,1
1429,Italy,1980,female,1,0,0,1
1430,Bulgaria,1980,female,0,2,0,2
1431,Poland,1980,female,0,1,3,4
1432,Czechoslovakia,1980,female,0,1,0,1
1433,Great Britain,1980,female,0,1,0,1
1434,Hungary,1980,female,0,1,0,1
1435,Denmark,1980,female,0,0,1,1
1436,Finland,1980,female,0,0,1,1
1437,Jamaica,1980,female,0,0,1,1
1438,United States,1984,female,20,22,8,50
1439,Romania,1984,female,8,5,7,20
1440,Canada,1984,female,4,2,1,7
1441,People's Republic of China,1984,female,4,1,1,6
1442,Netherlands,1984,female,3,0,4,7
1443,West Germany,1984,female,2,3,6,11
1444,Great Britain,1984,female,1,3,6,10
1445,Australia,1984,female,1,2,3,6
1446,Italy,1984,female,1,2,1,4
1447,Republic of Korea,1984,female,1,0,1,2
1448,Morocco,1984,female,1,0,0,1
1449,Sweden,1984,female,1,0,0,1
1450,Denmark,1984,female,0,1,0,1
1451,Finland,1984,female,0,1,0,1
1452,Norway,1984,female,0,1,0,1
1453,Belgium,1984,female,0,0,2,2
1454,France,1984,female,0,0,2,2
1455,Jamaica,1984,female,0,0,2,2
1456,Japan,1984,female,0,0,1,1
1457,Portugal,1984,female,0,0,1,1
1458,Switzerland,1984,female,0,0,1,1
1459,East Germany,1988,female,12,15,13,40
1460,Soviet Union,1988,female,10,6,12,28
1461,United States,1988,female,8,4,8,20
1462,Romania,1988,female,4,4,3,11
1463,West Germany,1988,female,4,3,2,9
1464,People's Republic of China,1988,female,3,5,3,11
1465,Bulgaria,1988,female,3,4,5,12
1466,Australia,1988,female,1,1,1,3
1467,Republic of Korea,1988,female,1,1,1,3
1468,Hungary,1988,female,1,1,0,2
1469,Yugoslavia,1988,female,1,0,1,2
1470,Canada,1988,female,1,0,0,1
1471,Netherlands,1988,female,1,0,0,1
1472,Portugal,1988,female,1,0,0,1
1473,Great Britain,1988,female,0,2,2,4
1474,France,1988,female,0,1,1,2
1475,Japan,1988,female,0,1,1,2
1476,Argentina,1988,female,0,1,0,1
1477,Costa Rica,1988,female,0,1,0,1
1478,Jamaica,1988,female,0,1,0,1
1479,Poland,1988,female,0,0,1,1
1480,Switzerland,1988,female,0,0,1,1
1481,People's Republic of China,1992,female,11,10,6,27
1482,Unified Team,1992,female,9,11,7,27
1483,United States,1992,female,9,9,14,32
1484,Germany,1992,female,8,5,8,21
1485,Hungary,1992,female,4,3,0,7
1486,Republic of Korea,1992,female,3,2,1,6
1487,France,1992,female,3,1,3,7
1488,Romania,1992,female,3,1,2,6
1489,Spain,1992,female,2,2,1,5
1490,Cuba,1992,female,2,1,4,7
1491,Japan,1992,female,1,4,3,8
1492,Australia,1992,female,1,3,5,9
1493,Great Britain,1992,female,1,1,2,4
1494,Italy,1992,female,1,1,0,2
1495,Netherlands,1992,female,1,0,4,5
1496,Canada,1992,female,1,0,2,3
1497,New Zealand,1992,female,1,0,1,2
1498,Algeria,1992,female,1,0,0,1
1499,Estonia,1992,female,1,0,0,1
1500,Ethiopia,1992,female,1,0,0,1
1501,Greece,1992,female,1,0,0,1
1502,Indonesia,1992,female,1,0,0,1
1503,Norway,1992,female,1,0,0,1
1504,Bulgaria,1992,female,0,3,2,5
1505,Jamaica,1992,female,0,2,1,3
1506,Belgium,1992,female,0,1,1,2
1507,Independent Olympic Athletes,1992,female,0,1,1,2
1508,Israel,1992,female,0,1,0,1
1509,South Africa,1992,female,0,1,0,1
1510,Poland,1992,female,0,0,2,2
1511,Colombia,1992,female,0,0,1,1
1512,Democratic People's Republic of Korea,1992,female,0,0,1,1
1513,Mongolia,1992,female,0,0,1,1
1514,Türkiye,1992,female,0,0,1,1
1515,United States,1996,female,8,8,10,26
1516,People's Republic of China,1996,female,7,7,4,18
1517,France,1996,female,7,3,4,14
1518,Russian Federation,1996,female,6,7,2,15
1519,Ukraine,1996,female,4,1,3,8
1520,Germany,1996,female,3,7,5,15
1521,Republic of Korea,1996,female,3,2,1,6
1522,Ireland,1996,female,3,0,1,4
1523,Italy,1996,female,2,4,5,11
1524,Romania,1996,female,2,3,4,9
1525,Hungary,1996,female,2,0,3,5
1526,South Africa,1996,female,2,0,1,3
1527,Australia,1996,female,1,4,3,8
1528,Cuba,1996,female,1,2,3,6
1529,Japan,1996,female,1,2,2,5
1530,Jamaica,1996,female,1,2,0,3
1531,Belarus,1996,female,1,1,1,3
1532,Belgium,1996,female,1,1,1,3
1533,Bulgaria,1996,female,1,1,1,3
1534,Poland,1996,female,1,1,1,3
1535,Czechia,1996,female,1,0,2,3
1536,Nigeria,1996,female,1,0,2,3
1537,Denmark,1996,female,1,0,1,2
1538,Ethiopia,1996,female,1,0,1,2
1539,Serbia and Montenegro,1996,female,1,0,1,2
1540,Costa Rica,1996,female,1,0,0,1
1541,Democratic People's Republic of Korea,1996,female,1,0,0,1
1542,Finland,1996,female,1,0,0,1
1543,"Hong Kong, China",1996,female,1,0,0,1
1544,Portugal,1996,female,1,0,0,1
1545,Sweden,1996,female,1,0,0,1
1546,Syrian Arab Republic,1996,female,1,0,0,1
1547,Canada,1996,female,0,4,3,7
1548,Netherlands,1996,female,0,3,5,8
1549,New Zealand,1996,female,0,2,0,2
1550,Spain,1996,female,0,1,2,3
1551,Indonesia,1996,female,0,1,1,2
1552,Chinese Taipei,1996,female,0,1,0,1
1553,Greece,1996,female,0,1,0,1
1554,Kenya,1996,female,0,1,0,1
1555,Slovenia,1996,female,0,1,0,1
1556,Austria,1996,female,0,0,1,1
1557,Great Britain,1996,female,0,0,1,1
1558,Mozambique,1996,female,0,0,1,1
1559,Norway,1996,female,0,0,1,1
1560,People's Republic of China,2000,female,13,6,7,26
1561,United States,2000,female,9,4,11,24
1562,Russian Federation,2000,female,7,13,6,26
1563,Netherlands,2000,female,7,2,0,9
1564,Italy,2000,female,5,2,3,10
1565,Romania,2000,female,4,5,5,14
1566,Australia,2000,female,3,5,4,12
1567,France,2000,female,3,5,3,11
1568,Republic of Korea,2000,female,3,2,4,9
1569,Great Britain,2000,female,3,1,4,8
1570,Belarus,2000,female,3,1,3,7
1571,Japan,2000,female,2,3,4,9
1572,Cuba,2000,female,2,3,1,6
1573,Ukraine,2000,female,2,2,2,6
1574,Hungary,2000,female,2,1,1,4
1575,Bulgaria,2000,female,2,1,0,3
1576,Poland,2000,female,2,1,0,3
1577,Germany,2000,female,1,4,6,11
1578,Sweden,2000,female,1,2,1,4
1579,Switzerland,2000,female,1,2,1,4
1580,Norway,2000,female,1,2,0,3
1581,Ethiopia,2000,female,1,1,1,3
1582,Spain,2000,female,1,0,3,4
1583,Lithuania,2000,female,1,0,1,2
1584,Algeria,2000,female,1,0,0,1
1585,Azerbaijan,2000,female,1,0,0,1
1586,Colombia,2000,female,1,0,0,1
1587,Czechia,2000,female,1,0,0,1
1588,Kazakhstan,2000,female,1,0,0,1
1589,Mexico,2000,female,1,0,0,1
1590,Mozambique,2000,female,1,0,0,1
1591,The Bahamas,2000,female,1,0,0,1
1592,Jamaica,2000,female,0,3,2,5
1593,Greece,2000,female,0,3,1,4
1594,Nigeria,2000,female,0,2,0,2
1595,Slovakia,2000,female,0,2,0,2
1596,Canada,2000,female,0,1,3,4
1597,Chinese Taipei,2000,female,0,1,3,4
1598,Indonesia,2000,female,0,1,2,3
1599,Democratic People's Republic of Korea,2000,female,0,1,1,2
1600,South Africa,2000,female,0,1,1,2
1601,Austria,2000,female,0,1,0,1
1602,Denmark,2000,female,0,1,0,1
1603,Ireland,2000,female,0,1,0,1
1604,Serbia and Montenegro,2000,female,0,1,0,1
1605,Sri Lanka,2000,female,0,1,0,1
1606,Vietnam,2000,female,0,1,0,1
1607,Belgium,2000,female,0,0,2,2
1608,Costa Rica,2000,female,0,0,2,2
1609,Argentina,2000,female,0,0,1,1
1610,Iceland,2000,female,0,0,1,1
1611,India,2000,female,0,0,1,1
1612,Kenya,2000,female,0,0,1,1
1613,Morocco,2000,female,0,0,1,1
1614,New Zealand,2000,female,0,0,1,1
1615,Portugal,2000,female,0,0,1,1
1616,Thailand,2000,female,0,0,1,1
1617,Türkiye,2000,female,0,0,1,1
1618,People's Republic of China,2004,female,13,8,8,29
1619,Japan,2004,female,9,2,3,14
1620,Russian Federation,2004,female,8,11,9,28
1621,United States,2004,female,6,12,9,27
1622,Australia,2004,female,6,5,6,17
1623,Ukraine,2004,female,5,1,3,9
1624,Romania,2004,female,4,2,2,8
1625,Hungary,2004,female,4,1,0,5
1626,France,2004,female,3,6,5,14
1627,Germany,2004,female,3,4,5,12
1628,Netherlands,2004,female,3,3,3,9
1629,Cuba,2004,female,2,3,5,10
1630,Republic of Korea,2004,female,2,3,3,8
1631,Greece,2004,female,2,3,1,6
1632,Great Britain,2004,female,2,0,5,7
1633,Thailand,2004,female,2,0,3,5
1634,Norway,2004,female,2,0,0,2
1635,Italy,2004,female,1,4,2,7
1636,Canada,2004,female,1,3,1,5
1637,Poland,2004,female,1,2,3,6
1638,Belarus,2004,female,1,2,2,5
1639,Ethiopia,2004,female,1,1,2,4
1640,Zimbabwe,2004,female,1,1,1,3
1641,Austria,2004,female,1,1,0,2
1642,Bulgaria,2004,female,1,0,2,3
1643,Belgium,2004,female,1,0,1,2
1644,Jamaica,2004,female,1,0,1,2
1645,The Bahamas,2004,female,1,0,1,2
1646,Cameroon,2004,female,1,0,0,1
1647,Chinese Taipei,2004,female,1,0,0,1
1648,New Zealand,2004,female,1,0,0,1
1649,Slovakia,2004,female,1,0,0,1
1650,Sweden,2004,female,1,0,0,1
1651,Türkiye,2004,female,1,0,0,1
1652,Democratic People's Republic of Korea,2004,female,0,3,0,3
1653,Czechia,2004,female,0,2,2,4
1654,Mexico,2004,female,0,2,1,3
1655,Kenya,2004,female,0,2,0,2
1656,Spain,2004,female,0,1,2,3
1657,Indonesia,2004,female,0,1,0,1
1658,Latvia,2004,female,0,1,0,1
1659,Lithuania,2004,female,0,1,0,1
1660,Morocco,2004,female,0,1,0,1
1661,Serbia and Montenegro,2004,female,0,1,0,1
1662,South Africa,2004,female,0,1,0,1
1663,Azerbaijan,2004,female,0,0,2,2
1664,Colombia,2004,female,0,0,2,2
1665,Slovenia,2004,female,0,0,2,2
1666,Argentina,2004,female,0,0,1,1
1667,Denmark,2004,female,0,0,1,1
1668,Switzerland,2004,female,0,0,1,1
1669,Venezuela,2004,female,0,0,1,1
1670,People's Republic of China,2008,female,18,5,14,37
1671,United States,2008,female,9,18,14,41
1672,Russian Federation,2008,female,7,5,4,16
1673,Great Britain,2008,female,6,4,8,18
1674,Australia,2008,female,5,5,4,14
1675,Germany,2008,female,5,3,4,12
1676,Italy,2008,female,4,3,3,10
1677,Japan,2008,female,4,2,4,10
1678,Republic of Korea,2008,female,3,4,2,9
1679,Jamaica,2008,female,3,3,2,8
1680,Romania,2008,female,3,1,0,4
1681,Kenya,2008,female,2,3,2,7
1682,Ukraine,2008,female,2,2,4,8
1683,Democratic People's Republic of Korea,2008,female,2,2,1,5
1684,Netherlands,2008,female,2,1,2,5
1685,Czechia,2008,female,2,1,0,3
1686,Ethiopia,2008,female,2,1,0,3
1687,Cuba,2008,female,1,5,4,10
1688,Canada,2008,female,1,3,3,7
1689,Zimbabwe,2008,female,1,3,0,4
1690,France,2008,female,1,2,3,6
1691,Thailand,2008,female,1,1,2,4
1692,Kazakhstan,2008,female,1,1,1,3
1693,Bulgaria,2008,female,1,1,0,2
1694,Chinese Taipei,2008,female,1,1,0,2
1695,Slovakia,2008,female,1,1,0,2
1696,Brazil,2008,female,1,0,2,3
1697,Mexico,2008,female,1,0,1,2
1698,Belgium,2008,female,1,0,0,1
1699,Cameroon,2008,female,1,0,0,1
1700,Finland,2008,female,1,0,0,1
1701,New Zealand,2008,female,1,0,0,1
1702,Norway,2008,female,0,2,1,3
1703,Croatia,2008,female,0,1,3,4
1704,Belarus,2008,female,0,1,2,3
1705,Colombia,2008,female,0,1,1,2
1706,Nigeria,2008,female,0,1,1,2
1707,Poland,2008,female,0,1,1,2
1708,Slovenia,2008,female,0,1,1,2
1709,Spain,2008,female,0,1,1,2
1710,Lithuania,2008,female,0,1,0,1
1711,Mongolia,2008,female,0,1,0,1
1712,Portugal,2008,female,0,1,0,1
1713,Samoa,2008,female,0,1,0,1
1714,Sweden,2008,female,0,1,0,1
1715,Türkiye,2008,female,0,1,0,1
1716,Austria,2008,female,0,0,2,2
1717,Indonesia,2008,female,0,0,2,2
1718,Algeria,2008,female,0,0,1,1
1719,Argentina,2008,female,0,0,1,1
1720,Azerbaijan,2008,female,0,0,1,1
1721,Denmark,2008,female,0,0,1,1
1722,Egypt,2008,female,0,0,1,1
1723,Georgia,2008,female,0,0,1,1
1724,Hungary,2008,female,0,0,1,1
1725,Morocco,2008,female,0,0,1,1
1726,Switzerland,2008,female,0,0,1,1
1727,Uzbekistan,2008,female,0,0,1,1
1728,Venezuela,2008,female,0,0,1,1
1729,United States,2012,female,19,9,12,40
1730,People's Republic of China,2012,female,16,17,11,44
1731,Great Britain,2012,female,6,5,5,16
1732,Russian Federation,2012,female,4,11,10,25
1733,France,2012,female,4,3,6,13
1734,Japan,2012,female,4,3,4,11
1735,Republic of Korea,2012,female,4,0,1,5
1736,Netherlands,2012,female,3,2,3,8
1737,Ethiopia,2012,female,3,1,2,6
1738,Australia,2012,female,2,4,5,11
1739,Spain,2012,female,2,3,3,8
1740,Italy,2012,female,2,1,3,6
1741,Canada,2012,female,2,1,1,4
1742,Czechia,2012,female,2,1,1,4
1743,New Zealand,2012,female,2,1,0,3
1744,Hungary,2012,female,2,0,2,4
1745,Democratic People's Republic of Korea,2012,female,2,0,1,3
1746,Lithuania,2012,female,2,0,1,3
1747,Romania,2012,female,1,3,0,4
1748,Ukraine,2012,female,1,2,5,8
1749,Cuba,2012,female,1,2,1,4
1750,Colombia,2012,female,1,1,3,5
1751,Jamaica,2012,female,1,1,2,4
1752,Poland,2012,female,1,1,1,3
1753,Serbia,2012,female,1,1,0,2
1754,Brazil,2012,female,1,0,3,4
1755,Kazakhstan,2012,female,1,0,3,4
1756,Chinese Taipei,2012,female,1,0,1,2
1757,Croatia,2012,female,1,0,1,2
1758,South Africa,2012,female,1,0,1,2
1759,Bahrain,2012,female,1,0,0,1
1760,Ireland,2012,female,1,0,0,1
1761,Slovenia,2012,female,1,0,0,1
1762,Switzerland,2012,female,1,0,0,1
1763,Tunisia,2012,female,1,0,0,1
1764,Germany,2012,female,0,7,3,10
1765,Kenya,2012,female,0,3,3,6
1766,Belarus,2012,female,0,2,2,4
1767,Bulgaria,2012,female,0,2,0,2
1768,Sweden,2012,female,0,2,0,2
1769,Mexico,2012,female,0,1,4,5
1770,Thailand,2012,female,0,1,2,3
1771,Azerbaijan,2012,female,0,1,1,2
1772,Slovakia,2012,female,0,1,1,2
1773,Denmark,2012,female,0,1,0,1
1774,Egypt,2012,female,0,1,0,1
1775,Finland,2012,female,0,1,0,1
1776,Indonesia,2012,female,0,1,0,1
1777,Türkiye,2012,female,0,1,0,1
1778,Belgium,2012,female,0,0,2,2
1779,India,2012,female,0,0,2,2
1780,Cameroon,2012,female,0,0,1,1
1781,"Hong Kong, China",2012,female,0,0,1,1
1782,Malaysia,2012,female,0,0,1,1
1783,Mongolia,2012,female,0,0,1,1
1784,Singapore,2012,female,0,0,1,1
1785,Tajikistan,2012,female,0,0,1,1
1786,United States,2016,female,19,15,14,48
1787,People's Republic of China,2016,female,9,8,14,31
1788,Japan,2016,female,6,1,7,14
1789,Netherlands,2016,female,5,2,2,9
1790,Hungary,2016,female,5,1,2,8
1791,Russian Federation,2016,female,4,9,5,18
1792,Great Britain,2016,female,4,7,6,17
1793,Republic of Korea,2016,female,4,1,2,7
1794,Spain,2016,female,4,1,2,7
1795,France,2016,female,3,6,0,9
1796,Kenya,2016,female,3,3,1,7
1797,Canada,2016,female,3,1,5,9
1798,Australia,2016,female,3,1,3,7
1799,Germany,2016,female,2,4,3,9
1800,Sweden,2016,female,2,2,3,7
1801,Colombia,2016,female,2,1,1,4
1802,Thailand,2016,female,2,1,1,4
1803,Jamaica,2016,female,2,0,2,4
1804,Croatia,2016,female,2,0,1,3
1805,Greece,2016,female,2,0,1,3
1806,Italy,2016,female,1,5,2,8
1807,New Zealand,2016,female,1,4,2,7
1808,Poland,2016,female,1,2,2,5
1809,Democratic People's Republic of Korea,2016,female,1,2,1,4
1810,Denmark,2016,female,1,2,1,4
1811,Ethiopia,2016,female,1,1,3,5
1812,Bahrain,2016,female,1,1,0,2
1813,South Africa,2016,female,1,1,0,2
1814,Brazil,2016,female,1,0,2,3
1815,Belgium,2016,female,1,0,1,2
1816,Chinese Taipei,2016,female,1,0,1,2
1817,Slovenia,2016,female,1,0,1,2
1818,Argentina,2016,female,1,0,0,1
1819,Kosovo,2016,female,1,0,0,1
1820,Puerto Rico,2016,female,1,0,0,1
1821,The Bahamas,2016,female,1,0,0,1
1822,Kazakhstan,2016,female,0,2,6,8
1823,Belarus,2016,female,0,2,1,3
1824,Mexico,2016,female,0,2,0,2
1825,Azerbaijan,2016,female,0,1,3,4
1826,Switzerland,2016,female,0,1,2,3
1827,Bulgaria,2016,female,0,1,1,2
1828,Cuba,2016,female,0,1,1,2
1829,India,2016,female,0,1,1,2
1830,Serbia,2016,female,0,1,1,2
1831,Venezuela,2016,female,0,1,1,2
1832,Burundi,2016,female,0,1,0,1
1833,Indonesia,2016,female,0,1,0,1
1834,Ireland,2016,female,0,1,0,1
1835,Mongolia,2016,female,0,1,0,1
1836,Philippines,2016,female,0,1,0,1
1837,Czechia,2016,female,0,0,2,2
1838,Egypt,2016,female,0,0,2,2
1839,Tunisia,2016,female,0,0,2,2
1840,Ukraine,2016,female,0,0,2,2
1841,Côte d'Ivoire,2016,female,0,0,1,1
1842,Finland,2016,female,0,0,1,1
1843,Islamic Republic of Iran,2016,female,0,0,1,1
1844,Israel,2016,female,0,0,1,1
1845,Portugal,2016,female,0,0,1,1
1846,Türkiye,2016,female,0,0,1,1
1847,United States,2020,female,17,16,18,51
1848,People's Republic of China,2020,female,15,13,7,35
1849,Japan,2020,female,13,6,8,27
1850,Australia,2020,female,7,2,7,16
1851,Germany,2020,female,5,2,3,10
1852,ROC,2020,female,4,10,6,20
1853,Great Britain,2020,female,4,6,8,18
1854,Netherlands,2020,female,4,3,9,16
1855,Canada,2020,female,3,3,4,10
1856,Switzerland,2020,female,3,2,3,8
1857,New Zealand,2020,female,3,1,2,6
1858,Brazil,2020,female,2,3,1,6
1859,Kenya,2020,female,2,2,1,5
1860,Bulgaria,2020,female,2,1,2,5
1861,Jamaica,2020,female,2,1,2,5
1862,Serbia,2020,female,2,0,1,3
1863,Belgium,2020,female,2,0,0,2
1864,Kosovo,2020,female,2,0,0,2
1865,France,2020,female,1,4,3,8
1866,Italy,2020,female,1,3,7,11
1867,Spain,2020,female,1,3,1,5
1868,Republic of Korea,2020,female,1,2,1,4
1869,South Africa,2020,female,1,2,0,3
1870,Chinese Taipei,2020,female,1,1,4,6
1871,Türkiye,2020,female,1,1,3,5
1872,Austria,2020,female,1,1,2,4
1873,Poland,2020,female,1,1,1,3
1874,Ecuador,2020,female,1,1,0,2
1875,Philippines,2020,female,1,1,0,2
1876,Slovenia,2020,female,1,1,0,2
1877,Denmark,2020,female,1,0,3,4
1878,Egypt,2020,female,1,0,2,3
1879,Israel,2020,female,1,0,1,2
1880,Thailand,2020,female,1,0,1,2
1881,Bermuda,2020,female,1,0,0,1
1882,Croatia,2020,female,1,0,0,1
1883,Ireland,2020,female,1,0,0,1
1884,Puerto Rico,2020,female,1,0,0,1
1885,Slovakia,2020,female,1,0,0,1
1886,The Bahamas,2020,female,1,0,0,1
1887,Uganda,2020,female,1,0,0,1
1888,Venezuela,2020,female,1,0,0,1
1889,Ukraine,2020,female,0,2,6,8
1890,"Hong Kong, China",2020,female,0,2,2,4
1891,Colombia,2020,female,0,2,0,2
1892,Sweden,2020,female,0,2,0,2
1893,Azerbaijan,2020,female,0,1,2,3
1894,Belarus,2020,female,0,1,2,3
1895,India,2020,female,0,1,2,3
1896,Cuba,2020,female,0,1,1,2
1897,Dominican Republic,2020,female,0,1,1,2
1898,Hungary,2020,female,0,1,1,2
1899,Kyrgyzstan,2020,female,0,1,1,2
1900,Nigeria,2020,female,0,1,1,2
1901,Bahrain,2020,female,0,1,0,1
1902,Czechia,2020,female,0,1,0,1
1903,Lithuania,2020,female,0,1,0,1
1904,Namibia,2020,female,0,1,0,1
1905,Portugal,2020,female,0,1,0,1
1906,Romania,2020,female,0,1,0,1
1907,Turkmenistan,2020,female,0,1,0,1
1908,Ethiopia,2020,female,0,0,2,2
1909,Kazakhstan,2020,female,0,0,2,2
1910,Mongolia,2020,female,0,0,2,2
1911,Côte d'Ivoire,2020,female,0,0,1,1
1912,Estonia,2020,female,0,0,1,1
1913,Finland,2020,female,0,0,1,1
1914,Indonesia,2020,female,0,0,1,1
1915,Mexico,2020,female,0,0,1,1
1916,San Marino,2020,female,0,0,1,1
